NO ./texture/minecraft(1).xpm
SO ./texture/nicpimp.xpm
WE ./texture/eagle.xpm
EA ./texture/nounours(1).xpm

G ./weapon_sprites/fist.xpm ./weapon_sprites/fist2.xpm ./weapon_sprites/fist3.xpm
G ./weapon_sprites/machinegun.xpm ./weapon_sprites/machinegun2.xpm ./weapon_sprites/chaingun.xpm
G ./weapon_sprites/gun.xpm ./weapon_sprites/gun2.xpm ./weapon_sprites/gun3.xpm ./weapon_sprites/gun4.xpm ./weapon_sprites/gun5.xpm ./weapon_sprites/handgun.xpm
G ./weapon_sprites/shotgun.xpm ./weapon_sprites/shotgun2.xpm ./weapon_sprites/shotgun3.xpm ./weapon_sprites/shotgun4.xpm ./weapon_sprites/gun5.xpm

F 80,10,10
C 40,40,40

        111111111111111111111
      110000000000000000000001
     100000000001111111111111111
    10000000000110000000000000001
    100000000000000000000000E0001
    10000000000110000000000000001
    10000000000011111100000111111
111110000000000000001111111110001
10001000000000000000000000000011
100010000000000000000000000001
10001000000000000000000000001
10001000000000000000000000001
10001000000000000000000000001
10001000000000000000000000001
11111000000000111111000000001
    10000000001   1000000001
    10000000001   1000000001
    10000000001   1000000001
    11111111111   1111111111