NO ./texture/minecraft(1).xpm
SO ./texture/nicpimp.xpm
WE ./texture/eagle.xpm
EA ./texture/nounours(1).xpm

F 80,10,10
C 40,40,40

 11111111111111111111111111111110
 1000   0000000000110000000000001
 1000   1011000001110000000000001
 1      1001000000000000000000001
011111111011000001110000000000001
100000000011000001110111111101110
01110111111111011100000010001
11112111111111011101010010001
01000000110101011100000010001
10000000000000000000000000001
10000000000000001101010010001
01000001110101011101011110N0011
11110110 1110101 101111000001
11111111 0111110 011111111110