NO ./texture/minecraft(1).xpm
SO ./texture/nicpimp.xpm
WE ./texture/eagle.xpm
EA ./texture/nounours(1).xpm

F 80,10,10
C 40,40,40

        1111111111111111111111111
        1000000000110000000000001
        1011000001110000000000001
        1001000000000000000000001
111111111011000001110000000000001
100000000011000001110111121101111
11110111111111011100000010001
11110111111111011101010010001
11000000110101011100000010001
10000000000000000200000000001
10000000000000001101010010001
1100000111010101111101111000011
11110111 1110101 1011110100N1
11111111 1111111 111111111111
