NO ./texture/minecraft(1).xpm
SO ./texture/nicpimp.xpm
WE ./texture/eagle.xpm
EA ./texture/nounours(1).xpm

F 220,100,0
C 225,30,0

11111
11111
11W11
11111
11111